{

    

    "7" : "┏",
    "8" : "┳",
    "9" : "┓",
    "6" : "┫",
    "3" : "┛",
    "2" : "┻",
    "4" : "┣",
    "1" : "┗",
    "5" : "╋",

    "minus" : "━",
    "slash" : "┃",

    "l" : "╻",
    "o" : "╹",
    "m" : "╺",
    "k" : "╸",

    

    "space" : " ",
    "A" : "S",
    "Z" : "L",
    "E" : "D",
    "R" : "C",

    "exclam" : "!"

    
}